01 01 01 01 02 03 03 04 09 02 03 04 05 02 04 09 09
01 01 01 01 06 07 07 08 09 06 07 08 05 06 08 09 09
01 01 01 01 10 11 11 12 09 10 11 12 05 10 12 09 09
09 09 09 09 09 09 09 09 09 09 09 09 09 09 09 09 09
01 01 01 01 02 03 03 04 09 02 03 04 05 02 04 09 09
01 01 01 02 07 07 07 08 09 06 07 08 05 06 08 09 09
01 01 02 07 07 07 07 08 09 06 07 08 05 06 08 09 09
01 01 06 07 07 07 07 08 09 06 07 08 05 06 08 09 09
01 01 10 11 11 11 11 12 09 10 11 12 05 10 12 09 09
05 05 05 05 05 05 05 05 05 05 05 05 05 05 05 09 09
01 01 02 03 03 03 03 04 09 02 03 04 05 02 04 09 09
01 01 10 11 11 11 11 12 09 10 11 12 05 10 12 09 09
