02 02 04 04 04 04 04 04 09 04 01 01 04 04 04 04 04 04 09 04 01 01 04 04 04 04 04 04 09 04 01 01 04 04 04 04 04 04 09 04 01 01 04 04 04 04 04 04 09 04 01 04 04 04 04 04 04 09 04 03 01 04 04 04 04 04 04 09 04 03
02 02 04 04 04 04 04 04 09 04 01 01 04 04 04 04 04 04 09 04 01 01 04 04 04 04 04 04 09 04 01 01 04 04 04 04 04 04 09 04 01 01 04 04 04 04 04 04 09 04 01 04 04 04 04 04 04 09 04 03 01 04 04 04 04 04 04 09 04 03
02 02 04 04 04 04 04 04 09 04 01 01 04 04 04 04 04 04 09 04 01 01 04 04 04 04 04 04 09 04 01 01 04 04 04 04 04 04 09 04 01 01 04 04 04 04 04 04 09 04 01 04 04 04 04 04 04 09 04 03 01 04 04 04 04 04 04 09 04 03
02 02 04 04 04 04 04 04 09 04 01 01 04 04 04 04 04 04 09 04 01 01 04 04 04 04 04 04 09 04 01 01 04 04 04 04 04 04 09 04 01 01 04 04 04 04 04 04 09 04 01 04 04 04 04 04 04 09 04 03 01 04 04 04 04 04 04 09 04 03

07 07 07 07 07 07 07 07 07 07 07 07 07 07 07 07 07 07 07 07 07 07 07 07 07 07 07 07 07 07 07 07 07 07 07 07 07 07 07 07 07 07 07 07 07 07 07 07 07 07 07 07 07 07 07 07 07 07 07 07 07 07 07 07 07 07 07 07 07 07
02 02 04 04 04 04 04 04 09 04 01 01 04 04 04 04 04 04 09 04 01 01 04 04 04 04 04 04 09 04 01 01 04 04 04 04 04 04 09 04 01 01 04 04 04 04 04 04 09 04 01 04 04 04 04 04 04 09 04 03 01 04 04 04 04 04 04 09 04 03
02 02 04 04 04 04 04 04 09 04 01 01 04 04 04 04 04 04 09 04 01 01 04 04 04 04 04 04 09 04 01 01 04 04 04 04 04 04 09 04 01 01 04 04 04 04 04 04 09 04 01 04 04 04 04 04 04 09 04 03 01 04 04 04 04 04 04 09 04 03
02 02 04 04 04 04 04 04 09 04 01 01 04 04 04 04 04 04 09 04 01 01 04 04 04 04 04 04 09 04 01 01 04 04 04 04 04 04 09 04 01 01 04 04 04 04 04 04 09 04 01 04 04 04 04 04 04 09 04 03 01 04 04 04 04 04 04 09 04 03

02 02 04 04 04 04 04 04 09 04 01 01 04 04 04 04 04 04 09 04 01 01 04 04 04 04 04 04 09 04 01 01 04 04 04 04 04 04 09 04 01 01 04 04 04 04 04 04 09 04 01 04 04 04 04 04 04 09 04 03 01 04 04 04 04 04 04 09 04 03
02 02 04 04 04 04 04 04 09 04 01 01 04 04 04 04 04 04 09 04 01 01 04 04 04 04 04 04 09 04 01 01 04 04 04 04 04 04 09 04 01 01 04 04 04 04 04 04 09 04 01 04 04 04 04 04 04 09 04 03 01 04 04 04 04 04 04 09 04 03
08 08 08 08 08 08 08 08 08 08 08 08 08 08 08 08 08 08 08 08 08 08 08 08 08 08 08 08 08 08 08 08 08 08 08 08 08 08 08 08 08 08 08 08 08 08 08 08 08 08 08 08 08 08 08 08 08 08 08 08 08 08 08 08 08 08 08 08 08 08
02 02 04 04 04 04 04 04 09 04 01 01 04 04 04 04 04 04 09 04 01 01 04 04 04 04 04 04 09 04 01 01 04 04 04 04 04 04 09 04 01 01 04 04 04 04 04 04 09 04 01 04 04 04 04 04 04 09 04 03 01 04 04 04 04 04 04 09 04 03

02 02 04 04 04 04 04 04 09 04 01 01 04 04 04 04 04 04 09 04 01 01 04 04 04 04 04 04 09 04 01 01 04 04 04 04 04 04 09 04 01 01 04 04 04 04 04 04 09 04 01 04 04 04 04 04 04 09 04 03 01 04 04 04 04 04 04 09 04 03
02 02 04 04 04 04 04 04 09 04 01 01 04 04 04 04 04 04 09 04 01 01 04 04 04 04 04 04 09 04 01 01 04 04 04 04 04 04 09 04 01 01 04 04 04 04 04 04 09 04 01 04 04 04 04 04 04 09 04 03 01 04 04 04 04 04 04 09 04 03
02 02 04 04 04 04 04 04 09 04 01 01 04 04 04 04 04 04 09 04 01 01 04 04 04 04 04 04 09 04 01 01 04 04 04 04 04 04 09 04 01 01 04 04 04 04 04 04 09 04 01 04 04 04 04 04 04 09 04 03 01 04 04 04 04 04 04 09 04 03
02 02 04 04 04 04 04 04 09 04 01 01 04 04 04 04 04 04 09 04 01 01 04 04 04 04 04 04 09 04 01 01 04 04 04 04 04 04 09 04 01 01 04 04 04 04 04 04 09 04 01 04 04 04 04 04 04 09 04 03 01 04 04 04 04 04 04 09 04 03

02 02 04 04 04 04 04 04 09 04 01 01 04 04 04 04 04 04 09 04 01 01 04 04 04 04 04 04 09 04 01 01 04 04 04 04 04 04 09 04 01 01 04 04 04 04 04 04 09 04 01 04 04 04 04 04 04 09 04 03 01 04 04 04 04 04 04 09 04 03
02 02 04 04 04 04 04 04 09 04 01 01 04 04 04 04 04 04 09 04 01 01 04 04 04 04 04 04 09 04 01 01 04 04 04 04 04 04 09 04 01 01 04 04 04 04 04 04 09 04 01 04 04 04 04 04 04 09 04 03 01 04 04 04 04 04 04 09 04 03
10 10 10 10 10 10 10 10 10 10 10 10 10 10 10 10 10 10 10 10 10 10 10 10 10 10 10 10 10 10 10 10 10 10 10 10 10 10 10 10 10 10 10 10 10 10 10 10 10 10 10 10 10 10 10 10 10 10 10 10 10 10 10 10 10 10 10 10 10 10
02 02 04 04 04 04 04 04 09 04 01 01 04 04 04 04 04 04 09 04 01 01 04 04 04 04 04 04 09 04 01 01 04 04 04 04 04 04 09 04 01 01 04 04 04 04 04 04 09 04 01 04 04 04 04 04 04 09 04 03 01 04 04 04 04 04 04 09 04 03

02 02 04 04 04 04 04 04 09 04 01 01 04 04 04 04 04 04 09 04 01 01 04 04 04 04 04 04 09 04 01 01 04 04 04 04 04 04 09 04 01 01 04 04 04 04 04 04 09 04 01 04 04 04 04 04 04 09 04 03 01 04 04 04 04 04 04 09 04 03
02 02 04 04 04 04 04 04 09 04 01 01 04 04 04 04 04 04 09 04 01 01 04 04 04 04 04 04 09 04 01 01 04 04 04 04 04 04 09 04 01 01 04 04 04 04 04 04 09 04 01 04 04 04 04 04 04 09 04 03 01 04 04 04 04 04 04 09 04 03
02 02 04 04 04 04 04 04 09 04 01 01 04 04 04 04 04 04 09 04 01 01 04 04 04 04 04 04 09 04 01 01 04 04 04 04 04 04 09 04 01 01 04 04 04 04 04 04 09 04 01 04 04 04 04 04 04 09 04 03 01 04 04 04 04 04 04 09 04 03
02 02 04 04 04 04 04 04 09 04 01 01 04 04 04 04 04 04 09 04 01 01 04 04 04 04 04 04 09 04 01 01 04 04 04 04 04 04 09 04 01 01 04 04 04 04 04 04 09 04 01 04 04 04 04 04 04 09 04 03 01 04 04 04 04 04 04 09 04 03

02 02 04 04 04 04 04 04 09 04 01 01 04 04 04 04 04 04 09 04 01 01 04 04 04 04 04 04 09 04 01 01 04 04 04 04 04 04 09 04 01 01 04 04 04 04 04 04 09 04 01 04 04 04 04 04 04 09 04 03 01 04 04 04 04 04 04 09 04 03
02 02 04 04 04 04 04 04 09 04 01 01 04 04 04 04 04 04 09 04 01 01 04 04 04 04 04 04 09 04 01 01 04 04 04 04 04 04 09 04 01 01 04 04 04 04 04 04 09 04 01 04 04 04 04 04 04 09 04 03 01 04 04 04 04 04 04 09 04 03
11 11 11 11 11 11 11 11 11 11 11 11 11 11 11 11 11 11 11 11 11 11 11 11 11 11 11 11 11 11 11 11 11 11 11 11 11 11 11 11 11 11 11 11 11 11 11 11 11 11 11 11 11 11 11 11 11 11 11 11 11 11 11 11 11 11 11 11 11 11
02 02 04 04 04 04 04 04 09 04 01 01 04 04 04 04 04 04 09 04 01 01 04 04 04 04 04 04 09 04 01 01 04 04 04 04 04 04 09 04 01 01 04 04 04 04 04 04 09 04 01 04 04 04 04 04 04 09 04 03 01 04 04 04 04 04 04 09 04 03

02 02 04 04 04 04 04 04 09 04 01 01 04 04 04 04 04 04 09 04 01 01 04 04 04 04 04 04 09 04 01 01 04 04 04 04 04 04 09 04 01 01 04 04 04 04 04 04 09 04 01 04 04 04 04 04 04 09 04 03 01 04 04 04 04 04 04 09 04 03
02 02 04 04 04 04 04 04 09 04 01 01 04 04 04 04 04 04 09 04 01 01 04 04 04 04 04 04 09 04 01 01 04 04 04 04 04 04 09 04 01 01 04 04 04 04 04 04 09 04 01 04 04 04 04 04 04 09 04 03 01 04 04 04 04 04 04 09 04 03
02 02 04 04 04 04 04 04 09 04 01 01 04 04 04 04 04 04 09 04 01 01 04 04 04 04 04 04 09 04 01 01 04 04 04 04 04 04 09 04 01 01 04 04 04 04 04 04 09 04 01 04 04 04 04 04 04 09 04 03 01 04 04 04 04 04 04 09 04 03
02 02 04 04 04 04 04 04 09 04 01 01 04 04 04 04 04 04 09 04 01 01 04 04 04 04 04 04 09 04 01 01 04 04 04 04 04 04 09 04 01 01 04 04 04 04 04 04 09 04 01 04 04 04 04 04 04 09 04 03 01 04 04 04 04 04 04 09 04 03

02 02 04 04 04 04 04 04 09 04 01 01 04 04 04 04 04 04 09 04 01 01 04 04 04 04 04 04 09 04 01 01 04 04 04 04 04 04 09 04 01 01 04 04 04 04 04 04 09 04 01 04 04 04 04 04 04 09 04 03 01 04 04 04 04 04 04 09 04 03
02 02 04 04 04 04 04 04 09 04 01 01 04 04 04 04 04 04 09 04 01 01 04 04 04 04 04 04 09 04 01 01 04 04 04 04 04 04 09 04 01 01 04 04 04 04 04 04 09 04 01 04 04 04 04 04 04 09 04 03 01 04 04 04 04 04 04 09 04 03
02 02 04 04 04 04 04 04 09 04 01 01 04 04 04 04 04 04 09 04 01 01 04 04 04 04 04 04 09 04 01 01 04 04 04 04 04 04 09 04 01 01 04 04 04 04 04 04 09 04 01 04 04 04 04 04 04 09 04 03 01 04 04 04 04 04 04 09 04 03
02 02 04 04 04 04 04 04 09 04 01 01 04 04 04 04 04 04 09 04 01 01 04 04 04 04 04 04 09 04 01 01 04 04 04 04 04 04 09 04 01 01 04 04 04 04 04 04 09 04 01 04 04 04 04 04 04 09 04 03 01 04 04 04 04 04 04 09 04 03

02 02 04 04 04 04 04 04 09 04 01 01 04 04 04 04 04 04 09 04 01 01 04 04 04 04 04 04 09 04 01 01 04 04 04 04 04 04 09 04 01 01 04 04 04 04 04 04 09 04 01 04 04 04 04 04 04 09 04 03 01 04 04 04 04 04 04 09 04 03
02 02 04 04 04 04 04 04 09 04 01 01 04 04 04 04 04 04 09 04 01 01 04 04 04 04 04 04 09 04 01 01 04 04 04 04 04 04 09 04 01 01 04 04 04 04 04 04 09 04 01 04 04 04 04 04 04 09 04 03 01 04 04 04 04 04 04 09 04 03
06 06 06 06 06 06 06 06 06 06 06 06 06 06 06 06 06 06 06 06 06 06 06 06 06 06 06 06 06 06 06 06 06 06 06 06 06 06 06 06 06 06 06 06 06 06 06 06 06 06 06 06 06 06 06 06 06 06 06 06 06 06 06 06 06 06 06 06 06 06
02 02 04 04 04 04 04 04 09 04 01 01 04 04 04 04 04 04 09 04 01 01 04 04 04 04 04 04 09 04 01 01 04 04 04 04 04 04 09 04 01 01 04 04 04 04 04 04 09 04 01 04 04 04 04 04 04 09 04 03 01 04 04 04 04 04 04 09 04 03

02 02 04 04 04 04 04 04 09 04 01 01 04 04 04 04 04 04 09 04 01 01 04 04 04 04 04 04 09 04 01 01 04 04 04 04 04 04 09 04 01 01 04 04 04 04 04 04 09 04 01 04 04 04 04 04 04 09 04 03 01 04 04 04 04 04 04 09 04 03
02 02 04 04 04 04 04 04 09 04 01 01 04 04 04 04 04 04 09 04 01 01 04 04 04 04 04 04 09 04 01 01 04 04 04 04 04 04 09 04 01 01 04 04 04 04 04 04 09 04 01 04 04 04 04 04 04 09 04 03 01 04 04 04 04 04 04 09 04 03
02 02 04 04 04 04 04 04 09 04 01 01 04 04 04 04 04 04 09 04 01 01 04 04 04 04 04 04 09 04 01 01 04 04 04 04 04 04 09 04 01 01 04 04 04 04 04 04 09 04 01 04 04 04 04 04 04 09 04 03 01 04 04 04 04 04 04 09 04 03
02 02 04 04 04 04 04 04 09 04 01 01 04 04 04 04 04 04 09 04 01 01 04 04 04 04 04 04 09 04 01 01 04 04 04 04 04 04 09 04 01 01 04 04 04 04 04 04 09 04 01 04 04 04 04 04 04 09 04 03 01 04 04 04 04 04 04 09 04 03
